111111111111111111
100000000000000001
100000000000000001
100001000000000001
100000000100000001
10000P000100000001
100000000100000001
100000000000000001
100000000000000001
100000000000000001
111111111111111111