111111111111111111
100000000000000001
100000000010000001
100000000000000101
100000000001000001111111111111
10000P000000000000000000000001
100000000000000001111111111111
100000000000000101
100000000000000001
100000000000000001
111111111111111111