111111111111111111111111111
100000000000000000000000001
100000000000000000000000001
100000100000000100000000001
100000000000000000000000001
10000P000000000000000000001
100000000000000000000000001
100000010000000100000000001
100000000000000000000000001
100000000000000000000000001
111111111111111111111111111