NO	./textures/wall/redbrick.xpm
SO	./textures/wall/wood.xpm
WE	./textures/wall/greystone.xpm
EA	./textures/wall/purplestone.xpm
F 220,100,0
C 225,30,0

1111111111111111111111111111
1000000000000000000000000001
1101011111111111111100000001
100000000000000000000000111111111111111111111
100111111011000001110000000000000000000000001
100000000011000001110111111111111111111111111
11010111111111011100000010001
11010111111111011101010010001
11000000110101011100000010001
10000000000000001100000010001
10001300000000E0001010010001
1100000111010101111101111000111
11110111 1110101 101111010001
11111111111111111111111111111