NO	./textures/wall/redbrick.xpm
SO	./textures/wall/wood.xpm
WE	./textures/wall/greystone.xpm
EA	./textures/wall/purplestone.xpm
F 220,100,0
C 225,30,0

1111111111111111111111111111
1000202020202020200002000001
1101111211111111111100000001
100100000000000000000000111111111
100111111011000001110000000000001
100000000011000001110111111111111
11210111111111011100000010001
11010111111111011101010010001
11000000110101011100000010001
10000000000000001100000010001
10000000000000000001010010001
11000001110101011111011110N0111
11110111 1110101 101111010001
11111111 1111111 111111111111