NO	./textures/wall/redbrick.xpm
SO	./textures/wall/wood.xpm
WE	./textures/wall/greystone.xpm
EA	./textures/wall/purplestone.xpm
F 220,100,0
C 225,30,0

        11111111111111111111111111111111
11111111111111111111111111000001
10001    10000000000000000111111                                              1
11011    111111111111001101                                                 110111
100011111110000000000000001                                                10000001
100010000110111111111111111111111111111111                                1000000001
1000000001101               1000000000001                                100000000001
1000100001101               1000000000001111111111111111111111111111111110000000000001
100011111110111111          10000000000000000000000020203200200200302000200000E00000111
100011000000000001          1000101000001111111111111111111111111111111110000000000001
100011000000000001          1000010100001                                100000000001
10001100000000000111111111111000000000001                                 1000000001
10000000000000000000000000000000011111111                                  10000001
1000110000000000011111111111111011                                          111111
11111111111111111111111111111111111
