NO	./textures/wall/redbrick.xpm
SO	./textures/wall/wood.xpm
WE	./textures/wall/greystone.xpm
EA	./textures/wall/purplestone.xpm
F 220,100,0
C 225,30,0


     111111
    10000001
   1000000001
  100000000001
 10000000000001
100S000000000001
 10000000000001
  100000000001
   1000000001 
    10000001
     111111