NO	./textures/wall/redbrick.xpm
SO	./textures/wall/wood.xpm
WE	./textures/wall/greystone.xpm
EA	./textures/wall/purplestone.xpm
F 220,100,0
C 225,30,0

1111111111111111111111111
1000000000000000000000001
1000000000000000000000001
1000000000000000000000001
1000000000000000000000001
1000000000000000000000001
100000S000000000000000001
1000012100000000000000001
1000003000000000000000001
1000012100000000000000001
1000003000000000000000001
1000012100000000000000001
1000003000000000000000001
1000012100000000000000001
1000003000000000000000001
1000012100000000000000001
1000003000000000000000001
1000012100000000000000001
1000003000000000000000001
1111112100000000000000001
1111103000000000000000001
1000012100000000000000001
1000003000000000000000001
1111111111111111111111111