NO	./textures/wall/redbrick.xpm
SO	./textures/wall/wood.xpm
WE	./textures/wall/greystone.xpm
EA	./textures/wall/purplestone.xpm
F 220,100,0
C 225,30,0

        1111111111111111111111111        1111111111111111111111111         
        1000000000110000000000001        1000000000110000010000001 
        1211000001110000000000001        100000N001110000010000001 
        1001000000000000000000001        1000000000000000000000001
111111111011000001010000010000001111111111011000111210000010000001
1000000000110000011111011111111111  100000000011000001111111111111111
11110111111111111100000010001111101111010112110000000100011
1111011111111101110101000000111110111111111011001010000001
1100000011010101111000001000020000000110101011110000010001
100000001000000011000001000111100000001000000010000001000111
1000000000000000110101001000110000000000000001101010010001
110000011101010111111111100111000001110101011111011110011
11111111 101000000000001111111111111 1011111000000011211
1111111111211111111111211           1121111111111111101111111  
1000000000000000000000001          1000000000110000010000001    
1011000001110000000000001         1011000001110000010000001   
10010000000000000000000011111111   100100000020000000000001111111
111111111211000001010000000000001111111111011100001010000010000001
100000000011000001111101111111111100000000011000001111101111111111
11110111111111111100000010001111100111111111011100000010001
1111011111111101110101000000111110111111111011101010000001
1100000011010101111000001000111000000110101011110000010001
10000000100000001100001000000200000001000000011000001000111
1000000000000000110101001000110000000000000001101010010001
110000011101010111110111100111000001110101011111011110011
111111111111111111111111111111111111111111111111111111111
